#########
# #    B#
#    ####
#  #    #
#  ###  #
#   A   #
#########